0,0,0,0,0,0,0,0,0,0,0,0,0,0,0,0,0,0,0,0,0,0,0,0,0,0,0,0,0,0,0,0,0,0,0,0,0,0,0,0,0,0,0,0,0,0,0,0,0,0,0,0,0,0,0,0,0,0,0,0
0,0,0,0,0,0,0,0,0,0,0,0,0,0,0,0,0,0,0,0,0,0,0,30,43,70,0,0,452,401,181,402,0,0,0,0,0,0,0,0,0,0,0,0,0,0,0,0,0,0,0,0,0,0,0,0,0,0,0,0
0,0,0,0,0,0,0,0,0,0,0,0,0,0,0,0,0,0,0,0,0,0,11,0,0,0,43,0,0,0,30,251,0,0,0,0,0,0,0,0,0,0,0,0,0,0,0,0,0,0,0,0,0,0,0,0,0,0,0,0
0,0,0,0,0,0,0,0,0,0,0,0,0,0,0,0,0,0,0,0,0,0,0,0,0,0,0,0,0,0,0,0,0,0,0,0,0,0,0,0,0,0,0,0,0,0,0,0,0,0,0,0,0,0,0,0,0,0,0,0
0,0,0,0,0,0,0,0,0,0,0,0,0,0,0,0,0,0,0,0,0,0,0,0,0,0,0,0,0,0,0,0,0,0,0,0,0,0,0,0,0,0,0,0,0,0,0,0,0,0,0,0,0,0,0,0,0,0,0,0
0,0,0,0,0,0,0,0,0,0,0,0,0,0,0,0,0,0,0,0,0,0,0,0,0,0,0,0,0,0,0,0,0,0,0,0,0,0,0,0,0,0,0,0,0,0,0,0,0,0,0,0,0,0,0,0,0,0,0,0
0,0,0,0,0,0,0,0,0,0,0,0,0,0,0,0,0,0,0,0,0,0,0,0,0,0,0,0,0,0,0,0,0,0,0,0,0,0,0,0,0,0,0,0,0,0,0,0,0,0,0,0,0,0,0,0,0,0,0,0
0,0,0,0,0,0,0,0,0,0,0,0,0,0,0,0,0,0,0,0,0,0,0,0,0,0,0,0,0,0,0,0,0,0,0,0,0,0,0,0,0,0,0,0,0,0,0,0,0,0,0,0,0,0,0,0,0,0,0,0
0,0,0,0,0,0,0,0,0,0,0,0,0,0,0,0,0,0,0,0,1026,1026,1026,1026,1026,1026,1026,1026,1026,1026,1026,1026,1026,1026,1026,1026,0,0,0,0,0,0,0,0,0,0,0,0,0,0,0,0,0,0,0,0,0,0,0,0
0,0,0,0,0,0,0,0,0,0,0,0,0,0,0,0,0,0,1026,1026,1026,1026,1026,1026,1026,1026,1026,1026,1026,1026,1026,1026,1026,1026,1026,1026,1026,1026,1026,0,0,0,0,0,0,0,0,0,0,0,0,0,0,0,0,0,0,0,0,0
0,0,0,0,0,0,0,0,0,0,0,0,0,0,0,1026,1026,1026,1026,1026,1026,1026,1026,1026,1026,1026,1026,1026,1026,1026,1026,1026,1026,1026,1026,1026,1026,1026,1026,1026,1026,0,0,0,0,0,0,0,0,0,0,0,0,0,0,0,0,0,0,0
0,0,0,0,0,0,0,0,0,0,0,0,0,1026,1026,1026,1026,1026,1026,1026,1026,1026,1026,1026,1026,1026,1026,1026,1026,1026,1026,1026,1026,1026,1026,1026,1026,1026,1026,1026,1026,1026,0,0,0,0,0,0,0,0,0,0,0,0,0,0,0,0,0,0
0,0,0,0,0,0,0,0,0,0,0,0,1026,1026,1026,1026,1026,1026,1026,1026,1026,1026,1026,1026,1026,1026,1026,1026,1026,1026,1026,1026,1026,1026,1026,1026,1026,1026,1026,1026,1026,1026,1026,0,0,0,0,0,0,0,0,0,0,0,0,0,0,0,0,0
0,0,0,0,0,0,0,0,0,0,0,1026,1026,1026,1026,1026,1026,1026,1026,1026,1026,1026,1026,1026,1026,1026,1026,1026,1026,1026,1026,1026,1026,1026,1026,1026,1026,1026,1026,1026,1026,1026,1026,1026,0,0,0,0,0,0,0,0,0,0,0,0,0,0,0,0
0,0,0,0,0,0,0,0,0,0,1026,1026,1026,1026,1026,1026,1026,1026,1026,1026,1026,1026,0,0,0,0,0,0,0,0,0,0,0,0,0,1026,1026,1026,1026,1026,1026,1026,1026,1026,0,0,0,0,0,0,0,0,0,0,0,0,0,0,0,0
0,0,0,0,0,0,0,0,0,0,1026,1026,1026,1026,1026,1026,1026,1026,1026,0,0,0,0,0,0,0,0,0,0,0,0,0,0,0,0,0,1026,1026,1026,1026,1026,1026,1026,1026,1026,0,0,0,0,0,0,0,0,0,0,0,0,0,0,0
0,0,0,0,0,0,0,0,0,1026,1026,1026,1026,1026,1026,1026,1026,1026,0,0,0,0,0,0,0,0,0,0,0,0,0,0,0,0,0,0,0,1026,1026,1026,1026,1026,1026,1026,1026,1026,0,0,0,0,0,0,0,0,0,0,0,0,0,0
0,0,0,0,0,0,0,0,0,1026,1026,1026,1026,1026,1026,1026,1026,0,0,0,0,0,0,0,0,0,0,0,0,0,0,0,0,0,0,0,0,0,1026,1026,1026,1026,1026,1026,1026,1026,0,0,0,0,0,0,0,0,0,0,0,0,0,0
0,0,0,0,0,0,0,0,0,1026,1026,1026,1026,1026,1026,1026,1026,0,0,0,0,0,0,0,0,0,0,0,0,0,0,0,0,0,0,0,0,0,1026,1026,1026,1026,1026,1026,1026,1026,0,0,0,0,0,0,0,0,0,0,0,0,0,0
0,0,0,0,0,0,0,0,0,1026,1026,1026,1026,1026,1026,1026,1026,0,0,0,0,0,0,0,0,0,0,0,0,0,0,0,0,0,0,0,0,0,1026,1026,1026,1026,1026,1026,1026,1026,0,0,0,0,0,0,0,0,0,0,0,0,0,0
0,0,0,0,0,0,0,0,0,1026,1026,1026,1026,1026,1026,1026,1026,0,0,0,0,0,0,0,0,0,0,0,0,0,0,0,0,0,0,0,0,0,1026,1026,1026,1026,1026,1026,1026,1026,0,0,0,0,0,0,0,0,0,0,0,0,0,0
0,0,0,0,0,0,0,0,0,1026,1026,1026,1026,1026,1026,1026,1026,0,0,0,0,0,0,0,0,0,0,0,0,0,0,0,0,0,0,0,0,1026,1026,1026,1026,1026,1026,1026,1026,1026,0,0,0,0,0,0,0,0,0,0,0,0,0,0
0,0,0,0,0,0,0,0,0,1026,1026,1026,1026,1026,1026,1026,1026,1026,0,0,0,0,0,0,0,0,0,0,0,0,0,0,0,0,0,0,0,1026,1026,1026,1026,1026,1026,1026,1026,1026,0,0,0,0,0,0,0,0,0,0,0,0,0,0
0,0,0,0,0,0,0,0,0,1026,1026,1026,1026,1026,1026,1026,1026,1026,1026,0,0,0,0,0,0,0,0,0,0,0,0,0,0,0,0,0,1026,1026,1026,1026,1026,1026,1026,1026,1026,1026,0,0,0,0,0,0,0,0,0,0,0,0,0,0
0,0,0,0,0,0,0,0,0,0,0,1026,1026,1026,1026,1026,1026,1026,1026,1026,0,0,0,0,0,0,0,0,0,0,0,0,0,0,0,1026,1026,1026,1026,1026,1026,1026,1026,1026,1026,0,0,0,0,0,0,0,0,0,0,0,0,0,0,0
0,0,0,0,0,0,0,0,0,0,0,1026,1026,1026,1026,1026,1026,1026,1026,1026,1026,0,0,0,0,0,0,0,0,0,0,0,0,0,1026,1026,1026,1026,1026,1026,1026,1026,1026,1026,1026,0,0,0,0,0,0,0,0,0,0,0,0,0,0,0
0,0,0,0,0,0,0,0,0,0,0,0,1026,1026,1026,1026,1026,1026,1026,1026,1026,1026,1026,0,0,0,0,0,0,0,0,0,0,0,1026,1026,1026,1026,1026,1026,1026,1026,1026,1026,0,0,0,0,0,0,0,0,0,0,0,0,0,0,0,0
0,0,0,0,0,0,0,0,0,0,0,0,0,1026,1026,1026,1026,1026,1026,1026,1026,1026,1026,0,0,0,0,0,0,0,0,0,0,1026,1026,1026,1026,1026,1026,1026,1026,1026,1026,0,0,0,0,0,0,0,0,0,0,0,0,0,0,0,0,0
0,0,0,0,0,0,0,0,0,0,0,0,0,0,1026,1026,1026,1026,1026,1026,1026,1026,1026,1026,0,0,0,0,0,0,0,0,0,1026,1026,1026,1026,1026,1026,1026,1026,1026,0,0,0,0,0,0,0,0,0,0,0,0,0,0,0,0,0,0
0,0,0,0,0,0,0,0,0,0,0,0,0,0,0,1026,1026,1026,1026,1026,1026,1026,1026,1026,0,0,0,0,0,0,0,0,0,1026,1026,1026,1026,1026,1026,1026,1026,0,0,0,0,0,0,0,0,0,0,0,0,0,0,0,0,0,0,0
0,0,0,0,0,0,0,0,0,0,0,0,0,0,0,0,1026,1026,1026,1026,1026,1026,1026,1026,1026,0,0,0,0,0,0,0,1026,1026,1026,1026,1026,1026,1026,1026,0,0,0,0,0,0,0,0,0,0,0,0,0,0,0,0,0,0,0,0
0,0,0,0,0,0,0,0,0,0,0,0,0,0,0,0,0,1026,1026,1026,1026,1026,1026,1026,1026,0,0,0,0,0,0,0,1026,1026,1026,1026,1026,1026,1026,1026,0,0,0,0,0,0,0,0,0,0,0,0,0,0,0,0,0,0,0,0
0,0,0,0,0,0,0,0,0,0,0,0,0,0,0,0,0,1026,1026,1026,1026,1026,1026,1026,1026,0,0,0,0,0,0,0,1026,1026,1026,1026,1026,1026,1026,0,0,0,0,0,0,0,0,0,0,0,0,0,0,0,0,0,0,0,0,0
0,0,0,0,0,0,0,0,0,0,0,0,0,0,0,0,0,1026,1026,1026,1026,1026,1026,1026,1026,0,0,0,0,0,0,0,1026,1026,1026,1026,1026,1026,1026,0,0,0,0,0,0,0,0,0,0,0,0,0,0,0,0,0,0,0,0,0
0,0,0,0,0,0,0,0,0,0,0,0,0,0,0,0,0,1026,1026,1026,1026,1026,1026,1026,1026,0,0,0,0,0,0,0,1026,1026,1026,1026,1026,1026,1026,0,0,0,0,0,0,0,0,0,0,0,0,0,0,0,0,0,0,0,0,0
0,0,0,0,0,0,0,0,0,0,0,0,0,0,0,0,0,1026,1026,1026,1026,1026,1026,1026,1026,0,0,0,0,0,0,0,1026,1026,1026,1026,1026,1026,1026,0,0,0,0,0,0,0,0,0,0,0,0,0,0,0,0,0,0,0,0,0
0,0,0,0,0,0,0,0,0,0,0,0,0,0,0,0,0,1026,1026,1026,1026,1026,1026,1026,1026,0,0,0,0,0,0,0,1026,1026,1026,1026,1026,1026,1026,0,0,0,0,0,0,0,0,0,0,0,0,0,0,0,0,0,0,0,0,0
0,0,0,0,0,0,0,0,0,0,0,0,0,0,0,0,1026,1026,1026,1026,1026,1026,1026,1026,1026,0,0,0,0,0,0,0,0,1026,1026,1026,1026,1026,1026,1026,0,0,0,0,0,0,0,0,0,0,0,0,0,0,0,0,0,0,0,0
0,0,0,0,0,0,0,0,0,0,0,0,0,0,0,0,1026,1026,1026,1026,1026,1026,1026,1026,1026,0,0,0,0,0,0,0,0,1026,1026,1026,1026,1026,1026,1026,0,0,0,0,0,0,0,0,0,0,0,0,0,0,0,0,0,0,0,0
0,0,0,0,0,0,0,0,0,0,0,0,0,0,1026,1026,1026,1026,1026,1026,1026,1026,1026,1026,0,0,0,0,0,0,0,0,0,1026,1026,1026,1026,1026,1026,1026,1026,0,0,0,0,0,0,0,0,0,0,0,0,0,0,0,0,0,0,0
0,0,1026,1026,1026,1026,1026,1026,1026,1026,1026,1026,1026,1026,1026,1026,1026,1026,1026,1026,1026,1026,1026,1026,0,0,0,0,0,0,0,0,0,1026,1026,1026,1026,1026,1026,1026,1026,0,0,0,0,0,0,0,0,0,0,0,0,0,0,0,0,0,0,0
0,305,1026,1026,1026,1026,1026,1026,1026,1026,1026,1026,1026,1026,1026,1026,1026,1026,1026,1026,1026,1026,1026,0,0,0,0,0,0,0,0,0,0,0,1026,1026,1026,1026,1026,1026,1026,1026,0,0,0,0,0,0,0,0,0,0,0,0,0,0,0,0,0,0
0,305,1026,1026,1026,1026,1026,1026,1026,1026,1026,1026,1026,1026,1026,1026,1026,1026,1026,1026,1026,1026,0,0,0,0,0,0,0,0,0,0,0,0,1026,1026,1026,1026,1026,1026,1026,1026,1026,0,0,0,0,0,0,0,0,0,0,0,0,0,0,0,0,0
0,305,1026,1026,1026,1026,1026,1026,1026,1026,1026,1026,1026,1026,1026,1026,1026,1026,1026,1026,1026,0,0,0,0,0,0,0,0,0,0,0,0,0,0,1026,1026,1026,1026,1026,1026,1026,1026,1026,0,0,0,0,0,0,0,0,0,0,0,0,0,0,0,0
0,305,1026,1026,1026,1026,1026,1026,1026,1026,1026,1026,1026,1026,1026,1026,1026,1026,1026,0,0,0,0,0,0,0,0,0,0,0,0,0,0,0,0,0,1026,1026,1026,1026,1026,1026,1026,1026,1026,1026,0,0,0,0,0,0,0,0,0,0,0,0,0,0
0,0,1026,1026,1026,1026,1026,1026,1026,1026,1026,1026,1026,1026,1026,0,0,0,0,0,0,0,0,0,0,0,0,0,0,0,0,0,0,0,0,0,0,1026,1026,1026,1026,1026,1026,1026,1026,1026,1026,0,0,0,0,0,0,0,0,0,0,0,0,0
0,0,0,0,0,0,0,0,0,0,0,0,0,0,0,0,0,0,0,0,0,0,0,0,0,0,0,0,0,0,0,0,0,0,0,0,0,0,1026,1026,1026,1026,1026,1026,1026,1026,1026,1026,1026,0,0,0,0,0,0,0,0,0,0,0
0,0,0,0,0,0,0,0,0,0,0,0,0,0,0,0,0,0,0,0,0,0,0,0,0,0,0,0,0,0,0,0,0,0,0,0,0,0,0,1026,1026,1026,1026,1026,1026,1026,1026,1026,1026,1026,1026,0,0,0,0,0,0,0,0,0
0,0,0,0,0,0,0,0,0,0,0,0,0,0,0,0,0,0,0,0,0,0,0,0,0,0,0,0,0,0,0,0,0,0,0,0,0,0,0,0,1026,1026,1026,1026,1026,1026,1026,1026,1026,1026,1026,1026,1026,0,0,0,0,0,0,0
0,0,0,0,0,0,0,0,0,0,0,0,0,0,0,0,0,0,0,0,0,0,0,0,0,0,0,0,0,0,0,0,0,0,0,0,0,0,0,0,0,0,1026,1026,1026,1026,1026,1026,1026,1026,1026,1026,1026,1026,1026,0,0,0,0,0
0,0,0,0,0,0,0,0,0,0,0,0,0,0,0,0,0,0,0,0,0,0,0,0,0,0,0,0,0,0,0,0,0,0,0,0,0,0,0,0,0,0,0,1026,1026,1026,1026,1026,1026,1026,1026,1026,1026,1026,1026,1026,0,0,0,0
0,0,0,0,0,0,0,0,0,0,0,0,0,0,0,0,0,0,0,0,0,0,0,0,0,0,0,0,0,0,0,0,0,0,0,0,0,0,0,0,0,0,0,0,0,0,1026,1026,1026,1026,1026,1026,1026,1026,1026,1026,0,0,0,0
0,0,0,0,0,0,0,0,0,0,0,0,0,0,0,0,0,0,0,0,0,0,0,0,0,0,0,0,0,0,0,0,0,0,0,0,0,0,0,0,0,0,0,0,0,0,0,0,0,1026,1026,1026,1026,1026,1026,0,0,0,0,0
0,0,0,0,0,0,0,0,0,0,0,0,0,0,0,0,0,0,0,0,0,0,0,0,0,0,0,0,0,0,0,0,0,0,0,0,0,0,0,0,0,0,0,0,0,0,0,0,0,0,0,0,0,0,0,0,0,0,0,0
0,0,0,0,0,0,0,0,0,0,0,0,0,0,0,0,0,0,0,0,0,0,0,0,0,0,0,0,0,0,0,0,0,0,0,0,0,0,0,0,0,0,0,0,0,0,0,0,0,0,0,0,0,0,0,0,0,0,0,0
0,0,0,0,0,0,0,0,0,0,0,0,0,0,0,0,0,0,0,0,0,0,0,0,0,0,0,0,0,0,0,0,0,0,0,0,0,0,0,0,0,0,0,0,0,0,0,0,0,0,0,0,0,0,0,0,0,0,0,0
0,0,0,0,0,0,0,0,0,0,0,0,0,0,0,0,0,0,0,0,0,0,0,0,0,0,0,0,0,0,0,0,0,0,0,0,0,0,0,0,0,0,0,0,0,0,0,0,0,0,0,0,0,0,0,0,0,0,0,0
0,0,0,0,0,0,0,0,0,0,0,0,0,0,0,0,0,0,0,0,0,0,0,0,0,0,0,0,0,0,0,0,0,0,0,0,0,0,0,0,0,0,0,0,0,0,0,0,0,0,0,0,0,0,0,0,0,0,0,0
0,0,0,0,0,0,0,0,0,0,0,0,0,0,0,0,0,0,0,0,0,0,0,0,0,0,0,0,0,0,0,0,0,0,0,0,0,0,0,0,0,0,0,0,0,0,0,0,0,0,0,0,0,0,0,0,0,0,0,0
0,0,0,0,0,0,0,0,0,0,0,0,0,0,0,0,0,0,0,0,0,0,0,0,0,0,0,0,0,0,0,0,0,0,0,0,0,0,0,0,0,0,0,0,0,0,0,0,0,0,0,0,0,0,0,0,0,0,0,0